(supertux-level
  (version 3)
  (name (_ "Bakey Island"))
  (author "Vaesea")
  (license "CC-BY-SA 4.0 International")
  (allow-item-pocket "on")
  (icon "")
  (icon-locked "")
  (sector
    (name "main")
    (ambient-light
      (color 1 1 1)
    )
    (background
      (color 1 1 1 0.4)
      (scroll-speed-x -50)
      (scroll-speed-y -50)
      (speed 1.5)
      (image "/images/background/misc/fog.png")
      (z-pos 300)
    )
    (level
      (z-pos 50)
      (x 78)
      (y 86)
    )
    (level
      (z-pos 50)
      (level "welcome_bakey_island.stl")
      (x 17)
      (y 88)
    )
    (level
      (z-pos 50)
      (x 22)
      (y 82)
    )
    (level
      (z-pos 50)
      (x 28)
      (y 76)
    )
    (level
      (z-pos 50)
      (x 35)
      (y 70)
    )
    (level
      (z-pos 50)
      (x 38)
      (y 68)
    )
    (level
      (z-pos 50)
      (x 41)
      (y 71)
    )
    (level
      (z-pos 50)
      (x 41)
      (y 65)
    )
    (level
      (z-pos 50)
      (x 50)
      (y 71)
    )
    (level
      (z-pos 50)
      (x 50)
      (y 65)
    )
    (level
      (z-pos 50)
      (x 53)
      (y 68)
    )
    (level
      (z-pos 50)
      (x 65)
      (y 76)
    )
    (level
      (z-pos 50)
      (x 65)
      (y 86)
    )
    (level
      (z-pos 50)
      (x 84)
      (y 86)
    )
    (music
      (name "Music_Object")
      (file "/music/antarctic/worldmap_ice.music")
    )
    (special-tile
      (z-pos 50)
      (blocking #f)
      (map-message (_ "Come back later..."))
      (invisible-tile #t)
      (passive-message #t)
      (x 99)
      (y 86)
    )
    (tilemap
      (solid #f)
      (z-pos -100)
      (name "Water_Tiles")
      (width 100)
      (height 100)
      (tiles -10000 1)
    )
    (tilemap
      (solid #f)
      (z-pos 0)
      (name "Main_Tiles")
      (width 100)
      (height 100)
      (tiles -4126 0 204 -10 205 206 -86 0 204 205 216 -4 208 217 -5 208 209 -85 0 204 216 -2 208 217 -4 208 217 -4 208 209 -83 0 204 205 216 -11 208 -2 217 209 -82 0 204 216 -14 208 213 212 -81 0 204 216 -11 208 213 -3 211 212 -80 0 204 205 216 -2 208 217 -2 208 213 -6 211 212 -11 0 204 -9 205 206 -61 0 204 216 -3 208 213 -3 211 212 -15 0 204 -2 205 216 -9 208 215 -4 205 206 -56 0 207 -2 208 213 211 212 -18 0 204 216 -17 208 215 205 206 -54 0 210 -2 211 212 -19 0 204 216 208 -2 217 -17 208 215 205 206 -42 0 204 -2 205 206 -28 0 204 216 -16 208 217 -6 208 215 205 206 -39 0 204 216 -2 208 209 -28 0 207 -26 208 209 -38 0 204 216 -2 208 213 212 -17 0 204 -4 205 206 -5 0 207 -7 208 -2 217 -13 208 217 -3 208 209 -38 0 207 -3 208 215 206 -13 0 204 -3 205 216 -4 208 209 -5 0 210 214 -10 208 213 -5 211 214 217 -5 208 213 211 212 -2 0 204 -4 205 206 -29 0 204 216 -4 208 209 -9 0 204 -3 205 216 -8 208 215 206 -5 0 210 -10 211 212 -5 0 210 -6 211 212 -4 0 207 -4 208 215 -2 205 206 -26 0 207 208 217 -3 208 215 206 -7 0 204 216 -13 208 209 -34 0 207 -5 208 217 208 215 206 -24 0 204 216 -6 208 209 -5 0 204 205 216 -14 208 209 -34 0 207 -4 208 217 -3 208 215 205 206 -22 0 207 -7 208 209 -4 0 204 216 -14 208 213 211 212 -5 0 101 -20 102 103 -7 0 210 214 -9 208 215 206 -21 0 207 -7 208 209 -3 0 204 216 -6 208 217 -6 208 213 211 212 -5 0 101 102 113 -20 105 112 102 103 -6 0 210 214 -9 208 215 206 -20 0 207 -5 208 217 213 212 -2 0 204 216 -4 208 217 -7 208 213 211 212 -4 0 101 -2 102 113 -24 105 112 103 -6 0 210 214 -9 208 209 -20 0 207 208 217 -4 208 209 -3 0 207 -11 208 213 211 212 -5 0 101 113 -28 105 112 103 -6 0 207 -3 208 217 -5 208 215 206 -19 0 210 214 -4 208 213 212 -3 0 207 -9 208 213 211 212 -5 0 101 102 113 -30 105 112 103 -5 0 210 214 -9 208 215 206 -19 0 207 -3 208 213 212 -4 0 210 214 217 -6 208 213 212 -6 0 101 113 -33 105 112 103 -5 0 210 214 -9 208 209 -19 0 210 -3 211 212 -6 0 210 -7 211 212 -5 0 101 102 113 -35 105 106 -6 0 210 214 -8 208 209 -43 0 101 113 -37 105 112 103 -6 0 210 214 -7 208 215 206 -40 0 101 102 113 -39 105 112 102 103 -5 0 210 214 217 -6 208 209 -39 0 101 113 -43 105 112 103 -5 0 210 211 214 -5 208 209 -28 0 204 205 206 -7 0 101 113 -45 105 112 102 103 -5 0 210 214 -4 208 209 -27 0 204 216 208 209 -6 0 101 113 -48 105 112 103 -5 0 210 214 -2 208 213 212 -25 0 204 205 216 208 213 212 -5 0 101 113 -50 105 112 103 -5 0 210 214 208 209 -26 0 207 -3 208 209 -6 0 104 -52 105 106 -6 0 210 211 212 -24 0 204 205 216 -3 208 209 -5 0 101 113 -52 105 112 103 -31 0 204 216 -4 208 213 212 -4 0 101 113 -54 105 112 103 -11 0 204 -7 205 206 -8 0 204 205 216 -4 208 213 212 -4 0 101 113 -56 105 112 103 -10 0 207 -7 208 215 206 -6 0 204 216 -4 208 213 211 212 -4 0 101 113 -58 105 112 103 -9 0 207 -8 208 215 206 -5 0 207 -4 208 213 212 -5 0 101 113 -60 105 112 103 -8 0 207 -9 208 209 -4 0 204 216 -4 208 209 -5 0 101 113 -62 105 106 -8 0 207 -2 208 217 -6 208 215 206 -3 0 207 -5 208 209 -4 0 101 113 -63 105 112 102 103 -6 0 207 -8 208 -2 217 209 -3 0 207 -4 208 213 212 -2 0 101 102 113 -26 105 110 -11 108 111 -27 105 112 103 -5 0 207 -10 208 209 -2 0 204 216 -3 208 213 212 -2 0 101 113 -26 105 110 108 109 -11 0 107 111 -27 105 112 103 -4 0 210 214 -3 208 217 -5 208 209 -2 0 207 -4 208 209 -2 0 101 113 -25 105 110 108 109 -14 0 104 -28 105 112 103 -4 0 210 211 214 -6 208 213 212 -2 0 207 -3 208 213 212 -2 0 104 -25 105 110 109 -8 0 204 -3 205 206 -3 0 107 111 -28 105 135 -6 0 210 214 -4 208 213 212 -3 0 210 214 208 213 212 -2 0 101 113 -24 105 110 109 -9 0 207 208 217 208 215 206 -3 0 104 -28 105 134 -7 0 210 -4 211 212 -5 0 210 211 212 -3 0 104 -24 105 110 109 -10 0 207 -3 208 217 215 206 -2 0 104 -28 105 134 -24 0 104 -24 105 106 -11 0 207 -5 208 215 206 0 107 108 111 -26 105 134 -24 0 104 -23 105 110 109 -11 0 210 214 -5 208 209 -3 0 104 -26 105 134 -24 0 107 111 -21 105 110 109 -8 0 204 -2 205 206 0 210 211 214 -3 208 209 -3 0 104 -26 105 134 -17 0 204 205 206 -5 0 104 -20 105 110 109 -7 0 204 205 216 -2 208 215 206 -2 0 210 214 208 213 212 -3 0 104 -26 105 134 -8 0 204 205 206 -6 0 207 208 215 205 206 -3 0 104 -17 105 110 -2 108 109 -7 0 204 216 -5 208 215 206 -2 0 210 211 212 -4 0 104 -26 105 134 -5 0 204 -2 205 216 208 215 206 -5 0 207 -3 208 215 206 -2 0 107 111 -14 105 110 108 109 -10 0 207 -7 208 209 -9 0 104 -26 105 133 -4 0 204 216 -5 208 209 -5 0 207 -4 208 209 -3 0 104 -13 105 110 109 -11 0 204 216 -6 208 213 212 -9 0 104 -25 105 110 109 -3 0 204 216 -2 208 217 -3 208 209 -5 0 207 -4 208 215 206 -2 0 104 -12 105 110 109 -12 0 207 -6 208 213 212 -10 0 104 -25 105 106 -3 0 204 216 208 217 -4 208 213 212 -5 0 207 -5 208 209 -2 0 107 108 111 -8 105 110 108 109 -5 0 204 -2 205 206 -3 0 204 216 -5 208 213 212 -11 0 107 111 -23 105 110 109 -3 0 207 -7 208 209 -6 0 207 217 -4 208 215 206 -3 0 107 -8 108 109 -6 0 204 216 -2 208 209 -3 0 207 -5 208 213 212 -13 0 107 -4 108 111 -17 105 110 109 -4 0 207 -6 208 213 212 -6 0 210 214 -5 208 215 206 -16 0 204 205 216 208 213 211 212 -3 0 207 -4 208 213 212 -19 0 107 -17 108 109 -5 0 207 -4 208 213 211 212 -8 0 210 214 -5 208 215 206 -12 0 204 -2 205 216 -2 208 213 212 -5 0 207 -3 208 213 212 -44 0 210 -4 211 212 -11 0 210 214 -5 208 215 -3 205 206 -8 0 207 208 217 208 213 211 212 -6 0 207 -2 208 213 212 -63 0 210 214 -8 208 209 -8 0 210 -3 211 212 -8 0 210 -2 211 212 -65 0 210 -8 211 212 -84 0)
    )
    (tilemap
      (solid #t)
      (z-pos 1)
      (width 100)
      (height 100)
      (tiles -5950 0 101 -3 102 103 -84 0 101 -10 102 113 -3 105 112 102 103 -79 0 101 -2 102 113 -11 105 110 108 111 -2 105 112 103 -76 0 101 102 113 -2 105 110 111 -4 105 110 -5 108 109 0 107 111 -2 105 112 102 103 -2 0 136 137 138 -68 0 101 113 -2 105 110 108 109 107 -4 108 109 -8 0 107 108 111 -2 105 112 103 0 139 140 141 -68 0 104 105 110 108 109 -14 0 233 -3 0 107 111 -2 105 112 103 139 140 147 138 -67 0 107 108 109 -2 0 10 -14 20 11 -3 0 107 111 -2 105 106 142 146 140 141 -65 0 83 -6 0 21 101 -11 102 103 0 21 -4 0 107 -2 108 109 0 142 143 144 -62 0 101 102 103 -2 0 123 0 233 -2 0 21 104 -11 105 112 103 21 -9 0 123 -2 0 230 -59 0 101 102 113 105 112 102 103 -2 0 10 -2 20 17 104 -12 105 106 12 -7 20 11 -3 0 101 102 103 -57 0 101 113 -5 105 106 -2 0 21 136 138 21 104 -12 105 106 21 0 136 -4 137 138 14 11 -2 0 104 105 112 103 -56 0 104 -4 105 110 108 109 -2 0 21 139 141 21 107 -12 108 109 21 0 139 -4 140 141 0 14 11 0 107 111 105 106 -2 0 136 138 -51 0 101 113 -3 105 110 109 -4 0 21 139 141 14 -14 20 15 0 142 -4 143 144 -2 0 14 11 0 104 105 106 -2 0 139 147 138 -49 0 101 113 -2 105 110 108 109 -5 0 21 139 141 -8 0 170 -5 0 123 -2 0 101 -2 102 103 -5 0 21 0 104 105 112 103 0 142 146 147 138 -48 0 104 105 110 108 109 10 -6 20 15 142 144 -4 0 123 101 102 103 101 102 103 -3 0 101 -2 102 113 -2 105 112 103 0 69 70 71 14 11 107 111 105 112 103 0 142 143 144 -48 0 107 108 109 -2 0 21 -8 0 101 -4 102 103 104 105 106 104 105 112 103 -2 0 104 -6 105 112 103 72 73 80 71 21 0 107 111 105 106 -51 0 136 138 0 69 70 71 21 -2 0 101 102 103 230 0 101 113 -4 105 106 107 108 109 107 111 105 112 103 0 104 -7 105 112 103 79 73 74 21 -2 0 107 108 109 0 101 -2 102 103 -45 0 123 139 147 138 72 73 74 21 0 101 113 105 106 0 101 113 -5 105 106 0 181 184 187 107 111 105 106 0 104 -8 105 106 72 73 74 21 -4 0 101 102 113 -2 105 112 103 -41 0 83 0 69 71 142 143 144 75 76 77 21 0 104 105 110 109 0 104 -5 105 110 109 171 182 185 188 179 107 108 109 0 104 -8 105 106 75 76 77 21 0 69 71 0 104 -5 105 106 -40 0 101 102 103 75 77 -6 0 21 0 107 108 109 -2 0 104 -4 105 110 109 0 172 183 186 189 180 -4 0 107 111 -7 105 106 -2 0 83 21 0 75 77 83 104 -5 105 112 103 -38 0 101 113 105 112 103 0 10 -5 20 15 -6 0 107 111 105 110 108 109 -12 0 107 111 -6 105 106 -3 0 21 -4 0 104 -6 105 106 -37 0 101 113 -3 105 106 0 21 0 136 137 138 -3 0 101 103 -4 0 107 108 109 -15 0 107 111 -4 105 110 109 170 0 233 21 -2 0 83 0 104 -6 105 106 -3 0 136 138 -31 0 101 113 -3 105 110 109 233 21 136 148 145 144 -2 0 101 113 112 103 0 170 -20 0 107 -4 108 109 -4 0 21 0 123 -2 0 104 -5 105 110 109 69 70 71 139 147 138 -29 0 101 113 -3 105 110 109 -2 0 21 142 143 144 -2 0 101 113 -2 105 106 -24 0 181 184 187 -5 0 21 -3 0 230 104 -4 105 110 109 0 72 73 74 142 143 144 -28 0 101 113 -3 105 110 109 -3 0 21 -4 0 101 113 -3 105 106 -23 0 171 182 185 188 173 175 177 179 0 21 -4 0 107 108 111 105 110 109 -2 0 75 76 77 -30 0 101 113 -3 105 110 109 -4 0 21 123 -2 0 101 113 -3 105 110 109 -23 0 172 183 186 189 174 176 178 180 0 21 -3 0 136 137 138 107 108 109 -6 0 123 -29 0 104 -3 105 110 109 10 -4 20 15 -2 0 101 113 -3 105 110 109 -27 0 101 102 103 -3 0 21 -2 0 136 148 140 141 -2 0 170 -36 0 104 -3 105 106 0 21 -6 0 101 113 -3 105 110 109 -28 0 104 105 112 103 0 83 21 0 136 148 140 145 144 -4 0 10 -6 20 56 57 -15 40 -11 0 104 -2 105 110 109 0 21 -2 0 101 102 103 0 107 111 -2 105 110 109 -29 0 107 111 105 106 -2 0 21 0 139 140 145 144 -5 0 21 -3 0 136 -2 137 138 -27 0 107 -2 108 109 -2 0 21 0 101 113 105 106 -2 0 107 -2 108 109 -31 0 104 105 112 103 0 21 0 142 143 144 -6 0 21 0 136 137 148 -2 140 141 -28 0 69 71 -3 0 21 0 104 105 110 109 -37 0 107 111 105 106 0 14 -10 20 15 0 139 -4 140 141 -28 0 72 80 230 -2 0 21 0 107 108 109 -39 0 104 105 112 103 -9 0 123 0 230 233 142 146 -3 140 141 -28 0 72 73 74 0 115 21 115 233 69 70 71 -38 0 107 111 105 106 -5 0 101 -6 102 103 0 139 -2 140 145 144 -28 0 75 79 74 0 116 22 116 69 81 73 74 -37 0 170 0 107 108 109 -2 0 101 -2 102 113 -6 105 106 0 142 -2 143 144 -30 0 75 77 -2 0 114 0 72 73 78 77 -44 0 104 -3 105 110 -5 108 109 83 -40 0 75 76 77 -45 0 107 -3 108 109 -528 0)
    )
    (tilemap
      (solid #f)
      (z-pos 2)
      (width 100)
      (height 100)
      (tiles -5947 0 181 184 187 -91 0 101 -2 102 103 0 171 182 185 188 179 -90 0 104 -2 105 106 0 172 183 186 189 180 -90 0 107 -2 108 109 -398 0 101 103 0 101 -2 102 103 -91 0 101 102 113 112 102 113 -2 105 112 103 -89 0 101 113 -6 105 110 108 109 -76 0 101 102 103 -10 0 107 -7 108 109 -78 0 107 108 109 -508 0 101 102 103 -13 0 101 -2 102 103 -79 0 101 113 105 106 -13 0 104 -2 105 112 102 103 -77 0 104 105 110 109 -13 0 107 108 111 -2 105 106 -13 0 101 102 103 -61 0 107 108 109 -16 0 107 -2 108 109 -12 0 101 113 105 106 -95 0 101 113 105 110 109 -95 0 104 -2 105 106 -96 0 107 -2 108 109 -55 0 101 103 -81 0 101 -2 102 103 -12 0 101 113 106 -80 0 101 113 105 110 109 -11 0 101 113 110 109 -45 0 60 61 62 -32 0 104 105 110 109 -10 0 101 103 107 108 109 -46 0 63 64 65 -32 0 104 105 106 -11 0 104 112 103 -43 0 181 184 187 -2 0 66 67 68 -32 0 107 108 109 -11 0 107 108 109 -42 0 171 182 185 188 179 -95 0 172 183 186 189 180 -138 0 71 -57 0 181 184 187 -96 0 171 182 185 188 179 -95 0 172 183 186 189 180 -724 0)
    )
    (worldmap-spawnpoint
      (z-pos 50)
      (name "main")
      (x 17)
      (y 91)
    )
  )
  (tileset "images/ice_world.strf")
)
